0 0 0 0 0 0 0 0 0 0 0 0 0 0 0 0 0 0 0 0 0 0 0 0 0 0 0 0
0 0 0 0 0 0 0 0 0 0 0 0 0 0 0 0 0 0 0 0 0 0 0 0 0 0 0 0
0 0 0 0 0 0 0 0 0 0 0 0 0 0 0 0 0 0 0 0 0 0 0 0 0 0 0 0
0 0 0 0 0 0 0 0 725 830 986 0 0 0 0 0 785 830 977 0 0 0 0 0 0 0 0 0
0 0 0 0 0 0 0 0 0 0 0 0 0 0 0 0 0 0 0 0 0 0 0 0 0 0 0 0
0 0 0 0 0 0 0 0 999 1010 1010 1010 1010 1010 1010 1010 1010 1010 1007 0 0 0 0 0 0 0 0 0
0 0 0 0 0 0 0 0 989 989 989 989 989 686 989 989 989 989 989 0 0 0 0 0 0 0 0 0
0 0 0 0 0 0 0 0 989 1 989 989 989 686 989 989 989 322 989 0 0 0 0 0 0 0 0 0
0 0 0 0 0 0 0 0 989 989 989 989 989 686 989 989 989 989 989 0 0 0 0 0 0 0 0 0
0 0 0 0 0 0 0 0 999 1010 1010 1010 1010 1010 1010 1010 1010 1010 1007 0 0 0 0 0 0 0 0 0
0 0 0 0 0 0 0 0 0 0 0 0 0 0 0 0 0 0 0 0 0 0 0 0 0 0 0 0
0 0 0 0 0 0 0 0 968 830 947 0 0 0 0 0 911 830 902 0 0 0 0 0 0 0 0 0
0 0 0 0 0 0 0 0 0 0 0 0 0 0 0 0 0 0 0 0 0 0 0 0 0 0 0 0
0 0 0 0 0 0 0 0 0 0 0 0 0 0 0 0 0 0 0 0 0 0 0 0 0 0 0 0
0 0 0 0 0 0 0 0 0 0 0 0 0 0 0 0 0 0 0 0 0 0 0 0 0 0 0 0
0 0 0 0 0 0 0 0 0 0 0 0 0 0 0 0 0 0 0 0 0 0 0 0 0 0 0 0