0 0 0 0 0 0 0 0 0 0 0 0 0 0 0 0 0 0 0 0 0 0 0 0 0 0 0 0 
0 0 0 0 0 0 0 0 0 0 0 0 0 0 0 0 0 0 0 0 0 0 0 0 0 0 0 0 
0 0 0 0 0 0 0 0 0 0 0 0 0 0 0 0 0 0 0 0 0 0 0 0 0 0 0 0 
0 0 0 0 0 0 0 0 1818 1923 2079 0 0 0 0 0 1878 1923 2070 0 0 0 0 0 0 0 0 0 
0 0 0 0 0 0 0 0 0 0 0 0 0 0 0 0 0 0 0 0 0 0 0 0 0 0 0 0 
0 0 0 0 0 0 0 0 2092 2103 2103 2103 2103 2103 2103 2103 2103 2103 2100 0 0 0 0 0 0 0 0 0 
0 0 0 0 0 0 0 0 2082 2082 2082 2082 2082 1779 2082 2082 2082 2082 2082 0 0 0 0 0 0 0 0 0 
0 0 0 0 0 0 0 0 2082 1094 2082 2082 2082 1779 2082 2082 2082 1415 2082 0 0 0 0 0 0 0 0 0 
0 0 0 0 0 0 0 0 2082 2082 2082 2082 2082 1779 2082 2082 2082 2082 2082 0 0 0 0 0 0 0 0 0 
0 0 0 0 0 0 0 0 2092 2103 2103 2103 2103 2103 2103 2103 2103 2103 2100 0 0 0 0 0 0 0 0 0 
0 0 0 0 0 0 0 0 0 0 0 0 0 0 0 0 0 0 0 0 0 0 0 0 0 0 0 0 
0 0 0 0 0 0 0 0 2061 1923 2040 0 0 0 0 0 2004 1923 1995 0 0 0 0 0 0 0 0 0 
0 0 0 0 0 0 0 0 0 0 0 0 0 0 0 0 0 0 0 0 0 0 0 0 0 0 0 0 
0 0 0 0 0 0 0 0 0 0 0 0 0 0 0 0 0 0 0 0 0 0 0 0 0 0 0 0 
0 0 0 0 0 0 0 0 0 0 0 0 0 0 0 0 0 0 0 0 0 0 0 0 0 0 0 0 
0 0 0 0 0 0 0 0 0 0 0 0 0 0 0 0 0 0 0 0 0 0 0 0 0 0 0 0