0 0 0 0 0 0 0 0 0 0 0 0 0 0 0 0 0 0 0 0 0 0 0 0 0 0 0 0 
0 0 0 346 0 0 0 346 0 0 0 0 0 0 0 0 0 0 0 0 0 346 0 0 0 0 0 0 
0 0 346 346 0 0 0 0 0 0 0 0 0 0 0 0 0 0 0 0 0 0 0 0 0 0 0 0 
0 0 0 0 0 0 0 0 0 0 995 995 995 995 995 995 995 995 995 995 0 0 0 0 0 346 0 0 
0 0 0 0 0 0 0 0 0 0 995 1 989 989 989 989 989 989 989 995 0 0 0 0 0 0 0 0 
0 0 346 0 0 785 830 977 0 0 995 989 989 329 989 989 989 968 989 995 0 0 0 346 346 0 0 0 
0 0 346 0 0 0 0 0 0 0 995 329 329 329 989 989 989 830 989 995 0 0 0 346 0 0 0 0 
0 0 0 0 0 725 830 986 0 0 995 989 989 989 989 989 989 947 989 995 0 0 0 0 0 0 0 0 
0 0 0 0 0 0 0 0 0 0 995 989 989 989 989 989 989 989 989 995 0 0 0 0 0 0 0 0 
0 0 346 0 0 0 0 0 0 0 995 989 797 830 947 989 989 989 989 995 0 0 346 0 0 0 0 0 
0 0 0 0 0 0 0 0 0 0 995 989 989 989 989 989 989 989 989 995 0 0 346 0 0 346 0 0 
0 346 0 0 0 346 0 0 0 0 995 989 989 989 989 989 989 989 989 995 0 0 0 0 0 0 0 0 
0 0 0 0 0 0 0 0 0 0 995 995 995 995 995 995 995 995 995 995 0 0 0 0 0 0 0 0 
0 0 0 0 0 0 0 346 0 0 0 0 0 0 0 0 0 0 0 0 0 0 0 0 346 0 0 0 
0 0 0 0 346 0 0 0 0 0 0 0 0 0 346 0 0 0 0 0 0 0 0 0 0 0 0 0 
968 830 755 0 0 0 0 0 0 0 0 0 0 0 0 0 0 0 0 0 0 0 0 0 0 0 0 0

0 0 0 0 0 0 0 0 0 0 0 0 0 0 0 0 0 0 0 0 0 0 0 0 0 0 0 0 
0 0 0 1099 0 0 0 1099 0 0 0 0 0 0 0 0 0 0 0 0 0 1099 0 0 0 0 0 0 
0 0 1099 1099 0 0 0 0 0 0 0 0 0 0 0 0 0 0 0 0 0 0 0 0 0 0 0 0 
0 0 0 0 0 0 0 0 0 0 1102 1102 1102 1102 1102 1102 1102 1102 1102 1102 0 0 0 0 0 1099 0 0 
0 0 0 0 0 0 0 0 0 0 1102 0 1095 1095 1095 1095 1095 1095 1095 1102 0 0 0 0 0 0 0 0 
0 0 1099 0 0 1117 1108 1117 0 0 1102 1095 1095 1120 1095 1095 1095 1102 1095 1102 0 0 0 1099 1099 0 0 0 
0 0 1099 0 0 0 0 0 0 0 1102 1120 1120 1120 1095 1095 1095 1108 1095 1102 0 0 0 1099 0 0 0 0 
0 0 0 0 0 1105 1108 1105 0 0 1102 1095 1095 1095 1095 1095 1095 1099 1095 1102 0 0 0 0 0 0 0 0 
0 0 0 0 0 0 0 0 0 0 1102 1095 1095 1095 1095 1095 1095 1095 1095 1102 0 0 0 0 0 0 0 0 
0 0 1099 0 0 0 0 0 0 0 1102 1095 1113 1108 1099 1095 1095 1095 1095 1102 0 0 1099 0 0 0 0 0 
0 0 0 0 0 0 0 0 0 0 1102 1095 1095 1095 1095 1095 1095 1095 1095 1102 0 0 1099 0 0 1099 0 0 
0 1099 0 0 0 1099 0 0 0 0 1102 1095 1095 1095 1095 1095 1095 1095 1095 1102 0 0 0 0 0 0 0 0 
0 0 0 0 0 0 0 0 0 0 1102 1102 1102 1102 1102 1102 1102 1102 1102 1102 0 0 0 0 0 0 0 0 
0 0 0 0 0 0 0 1099 0 0 0 0 0 0 0 0 0 0 0 0 0 0 0 0 1099 0 0 0 
0 0 0 0 1099 0 0 0 0 0 0 0 0 0 1099 0 0 0 0 0 0 0 0 0 0 0 0 0 
1102 1108 1096 0 0 0 0 0 0 0 0 0 0 0 0 0 0 0 0 0 0 0 0 0 0 0 0 0