0 0 0 0 0 0 0 0 0 0 0 0 0 0 0 0 0 0 0 0 0 0 0 0 0 0 0 0 
0 0 0 0 0 0 0 0 0 0 0 0 0 0 0 0 0 0 0 0 0 0 0 0 0 0 0 0 
0 0 0 0 0 0 0 0 0 0 0 0 0 0 0 0 0 0 689 0 0 0 0 0 0 0 0 0 
0 0 0 0 0 689 0 0 0 0 0 0 0 0 0 0 0 0 0 0 0 0 0 0 0 0 0 0 
0 0 0 0 0 0 0 0 0 0 0 0 689 0 0 0 0 0 0 0 0 0 0 0 0 0 0 0 
0 0 0 0 0 0 989 989 989 989 989 0 0 0 0 0 0 0 0 0 0 0 0 0 0 0 0 0 
0 0 0 0 0 0 989 725 830 986 989 0 0 0 0 0 0 995 995 995 995 995 995 995 0 0 0 0 
0 0 0 0 0 0 989 989 989 989 989 0 0 0 0 0 0 995 112 112 112 995 968 995 0 0 0 0 
0 0 0 0 0 0 989 989 989 989 989 0 0 1 0 0 0 995 112 322 112 995 830 995 0 0 0 0 
0 0 0 689 0 0 989 785 830 977 989 0 0 0 0 0 0 995 112 112 112 995 947 995 0 0 0 0 
0 0 0 0 0 0 989 989 989 989 989 0 0 0 0 689 0 995 995 995 995 995 995 995 0 0 0 0 
0 0 0 0 0 0 0 0 0 0 0 0 0 0 0 0 0 0 0 0 0 0 0 0 0 0 0 0 
0 0 0 0 0 0 0 0 0 0 0 0 0 0 0 0 0 0 0 689 0 0 0 0 0 0 0 0 
0 0 0 0 0 0 0 689 0 0 0 0 0 0 0 0 0 0 0 0 0 0 0 0 0 0 0 0 
0 0 0 0 0 0 0 0 0 0 0 0 0 0 0 0 0 0 0 0 0 0 0 0 0 0 0 0 
0 0 0 0 0 0 0 0 0 0 0 0 0 0 0 0 0 0 0 0 0 0 0 0 0 0 0 0

0 0 0 0 0 0 0 0 0 0 0 0 0 0 0 0 0 0 0 0 0 0 0 0 0 0 0 0 
0 0 0 0 0 0 0 0 0 0 0 0 0 0 0 0 0 0 0 0 0 0 0 0 0 0 0 0 
0 0 0 0 0 0 0 0 0 0 0 0 0 0 0 0 0 0 1111 0 0 0 0 0 0 0 0 0 
0 0 0 0 0 1111 0 0 0 0 0 0 0 0 0 0 0 0 0 0 0 0 0 0 0 0 0 0 
0 0 0 0 0 0 0 0 0 0 0 0 1111 0 0 0 0 0 0 0 0 0 0 0 0 0 0 0 
0 0 0 0 0 0 1095 1095 1095 1095 1095 0 0 0 0 0 0 0 0 0 0 0 0 0 0 0 0 0 
0 0 0 0 0 0 1095 1097 1108 1097 1095 0 0 0 0 0 0 1102 1102 1102 1102 1102 1102 1102 0 0 0 0 
0 0 0 0 0 0 1095 1095 1095 1095 1095 0 0 0 0 0 0 1102 1121 1121 1121 1102 1102 1102 0 0 0 0 
0 0 0 0 0 0 1095 1095 1095 1095 1095 0 0 0 0 0 0 1102 1121 1124 1121 1102 1108 1102 0 0 0 0 
0 0 0 1111 0 0 1095 1117 1108 1117 1095 0 0 0 0 0 0 1102 1121 1121 1121 1102 1099 1102 0 0 0 0 
0 0 0 0 0 0 1095 1095 1095 1095 1095 0 0 0 0 1111 0 1102 1102 1102 1102 1102 1102 1102 0 0 0 0 
0 0 0 0 0 0 0 0 0 0 0 0 0 0 0 0 0 0 0 0 0 0 0 0 0 0 0 0 
0 0 0 0 0 0 0 0 0 0 0 0 0 0 0 0 0 0 0 1111 0 0 0 0 0 0 0 0 
0 0 0 0 0 0 0 1111 0 0 0 0 0 0 0 0 0 0 0 0 0 0 0 0 0 0 0 0 
0 0 0 0 0 0 0 0 0 0 0 0 0 0 0 0 0 0 0 0 0 0 0 0 0 0 0 0 
0 0 0 0 0 0 0 0 0 0 0 0 0 0 0 0 0 0 0 0 0 0 0 0 0 0 0 0