0 0 0 0 0 0 0 0 0 0 0 0 0 0 0 0 0 0 0 0 0 0 0 0 0 0 0 0 
0 0 0 0 0 0 0 0 0 0 0 1022 1010 1010 1010 1010 1010 1010 1031 0 0 0 0 0 0 346 0 0 
0 0 0 0 0 0 0 0 0 0 0 1025 0 0 0 0 0 0 1025 0 346 0 0 0 0 0 0 0 
0 0 0 0 0 0 0 0 0 0 0 1025 0 830 0 0 0 0 1025 0 0 0 0 0 0 0 0 0 
0 0 0 0 0 0 0 1022 1010 1010 1010 1013 0 0 0 0 977 0 1025 0 0 0 0 0 0 0 0 0 
0 0 346 0 0 0 0 1025 989 989 989 989 0 0 0 0 0 0 1025 0 0 0 346 0 0 0 0 0 
0 0 0 346 0 0 0 1025 989 785 989 989 0 322 0 0 0 0 1025 0 0 0 0 0 0 0 0 0 
0 0 0 0 0 0 0 1025 989 989 989 989 0 0 0 0 0 0 1025 0 0 0 0 0 0 0 0 0 
0 0 0 0 0 0 0 1004 1010 1010 1010 1034 1010 1010 1010 1010 1010 1010 1037 0 0 0 0 0 0 346 0 0 
0 0 0 0 0 0 0 0 0 0 0 1025 0 0 0 0 0 0 1025 0 0 0 0 0 346 364 0 0 
0 0 0 0 0 0 0 0 725 0 0 1025 0 968 0 0 0 0 1025 0 0 0 0 0 0 0 0 0 
0 0 0 0 0 0 0 0 830 0 0 1025 0 830 0 0 46 0 1025 0 0 0 0 0 0 0 0 0 
0 0 0 0 346 0 0 0 986 0 0 1025 0 947 0 0 0 0 1025 0 0 0 0 0 0 0 0 0 
0 0 0 0 0 0 0 0 0 0 0 1025 0 0 0 0 0 0 1025 0 0 346 0 0 0 0 0 0 
0 0 0 0 0 0 0 0 0 0 0 1004 1010 1010 1010 1010 1010 1010 1013 0 0 0 0 0 0 0 0 0 
0 0 0 0 0 0 0 0 346 0 0 0 0 0 0 0 0 0 0 0 0 0 0 0 0 0 0 0

0 0 0 0 0 0 0 0 0 0 0 0 0 0 0 0 0 0 0 0 0 0 0 0 0 0 0 0 
0 0 0 0 0 0 0 0 0 0 0 1102 1102 1102 1102 1102 1102 1102 1102 0 0 0 0 0 0 1099 0 0 
0 0 0 0 0 0 0 0 0 0 0 1102 0 0 0 0 0 0 1102 0 1099 0 0 0 0 0 0 0 
0 0 0 0 0 0 0 0 0 0 0 1102 0 1101 0 0 0 0 1102 0 0 0 0 0 0 0 0 0 
0 0 0 0 0 0 0 1102 1102 1102 1102 1102 0 0 0 0 1107 0 1102 0 0 0 0 0 0 0 0 0 
0 0 1099 0 0 0 0 1102 1095 1095 1095 1095 0 0 0 0 0 0 1102 0 0 0 1099 0 0 0 0 0 
0 0 0 1099 0 0 0 1102 1095 1107 1095 1095 0 1124 0 0 0 0 1102 0 0 0 0 0 0 0 0 0 
0 0 0 0 0 0 0 1102 1095 1095 1095 1095 0 0 0 0 0 0 1102 0 0 0 0 0 0 0 0 0 
0 0 0 0 0 0 0 1102 1102 1102 1102 1102 1102 1102 1102 1102 1102 1102 1102 0 0 0 0 0 0 1099 0 0 
0 0 0 0 0 0 0 0 0 0 0 1102 0 0 0 0 0 0 1102 0 0 0 0 0 1099 1099 0 0 
0 0 0 0 0 0 0 0 1105 0 0 1102 0 1101 0 0 0 0 1102 0 0 0 0 0 0 0 0 0 
0 0 0 0 0 0 0 0 0 0 0 1102 0 0 0 0 0 0 1102 0 0 0 0 0 0 0 0 0 
0 0 0 0 1099 0 0 0 1105 0 0 1102 0 1106 0 0 0 0 1102 0 0 0 0 0 0 0 0 0 
0 0 0 0 0 0 0 0 0 0 0 1102 0 0 0 0 0 0 1102 0 0 1099 0 0 0 0 0 0 
0 0 0 0 0 0 0 0 0 0 0 1102 1102 1102 1102 1102 1102 1102 1102 0 0 0 0 0 0 0 0 0 
0 0 0 0 0 0 0 0 1099 0 0 0 0 0 0 0 0 0 0 0 0 0 0 0 0 0 0 0