0 0 0 0 0 989 0 0 0 0 0 0 0 0 0 0 0 0 0 0 0 0 0 0 0 0 0 0 
0 0 0 0 0 0 0 0 0 0 0 322 322 322 322 322 322 322 322 0 0 0 0 0 989 0 0 0 
0 0 0 0 0 0 0 989 0 0 0 322 0 0 0 0 0 0 322 0 0 0 0 0 0 0 0 0 
0 0 0 989 0 0 0 0 0 0 0 322 0 830 0 0 0 0 322 0 989 0 0 0 0 0 0 0 
0 0 0 0 0 0 0 322 322 322 322 322 0 0 0 0 977 0 322 0 0 0 0 0 0 0 0 0 
0 0 0 0 0 0 0 322 370 361 386 382 0 0 0 0 0 0 322 0 0 0 0 0 989 0 0 0 
0 0 0 0 989 0 0 322 378 725 378 388 0 0 0 0 0 0 322 0 0 0 989 0 0 0 0 0 
0 0 0 0 0 0 0 322 355 361 367 364 0 0 0 0 0 0 322 0 0 0 0 0 0 0 0 0 
0 0 0 0 0 0 0 322 322 322 322 322 322 322 322 322 322 322 322 0 0 0 0 0 0 0 0 0 
0 989 0 0 0 0 0 0 0 0 0 322 0 0 0 0 0 0 322 0 0 0 0 0 0 0 0 0 
0 0 0 0 0 0 0 0 968 0 0 322 0 785 0 0 0 0 322 0 0 0 989 0 0 0 0 0 
0 0 0 0 0 989 0 0 830 0 0 322 0 830 0 0 995 0 322 0 0 0 0 989 0 0 0 0 
0 0 0 0 0 0 0 0 986 0 0 322 0 947 0 0 0 0 322 0 0 0 0 0 0 0 0 0 
0 0 0 989 0 0 0 0 0 0 0 322 0 0 0 322 322 322 322 989 0 0 0 0 0 0 0 0 
0 0 0 0 0 0 989 0 0 0 0 322 322 322 322 322 0 0 0 0 0 0 0 0 0 0 0 0 
0 0 0 0 0 0 0 0 0 0 0 0 0 0 0 0 0 0 0 0 0 0 0 0 0 0 0 0

0 0 0 0 0 1095 0 0 0 0 0 0 0 0 0 0 0 0 0 0 0 0 0 0 0 0 0 0 
0 0 0 0 0 0 0 0 0 0 0 1124 1124 1124 1124 1124 1124 1124 1124 0 0 0 0 0 1095 0 0 0 
0 0 0 0 0 0 0 1095 0 0 0 1124 0 0 0 0 0 0 1124 0 0 0 0 0 0 0 0 0 
0 0 0 1095 0 0 0 0 0 0 0 1124 0 1101 0 0 0 0 1124 0 1095 0 0 0 0 0 0 0 
0 0 0 0 0 0 0 1124 1124 1124 1124 1124 0 0 0 0 1107 0 1124 0 0 0 0 0 0 0 0 0 
0 0 0 0 0 0 0 1124 1099 1099 1099 1099 0 0 0 0 0 0 1124 0 0 0 0 0 1095 0 0 0 
0 0 0 0 1095 0 0 1124 1099 1098 1099 1099 0 0 0 0 0 0 1124 0 0 0 1095 0 0 0 0 0 
0 0 0 0 0 0 0 1124 1099 1099 1099 1099 0 0 0 0 0 0 1124 0 0 0 0 0 0 0 0 0 
0 0 0 0 0 0 0 1124 1124 1124 1124 1124 1124 1124 1124 1124 1124 1124 1124 0 0 0 0 0 0 0 0 0 
0 1095 0 0 0 0 0 0 0 0 0 1124 0 0 0 0 0 0 1124 0 0 0 0 0 0 0 0 0 
0 0 0 0 0 0 0 0 1101 0 0 1124 0 1124 0 0 0 0 1124 0 0 0 1095 0 0 0 0 0 
0 0 0 0 0 1095 0 0 0 0 0 1124 0 0 0 0 1102 0 1124 0 0 0 0 1095 0 0 0 0 
0 0 0 0 0 0 0 0 1105 0 0 1124 0 1106 0 0 0 0 1124 0 0 0 0 0 0 0 0 0 
0 0 0 1095 0 0 0 0 0 0 0 1124 0 0 0 1124 1124 1124 1124 1095 0 0 0 0 0 0 0 0 
0 0 0 0 0 0 1095 0 0 0 0 1124 1124 1124 1124 1124 0 0 0 0 0 0 0 0 0 0 0 0 
0 0 0 0 0 0 0 0 0 0 0 0 0 0 0 0 0 0 0 0 0 0 0 0 0 0 0 0