725 968 1025 0 0 0 0 0 0 0 0 0 0 0 0 0 0 0 0 0 346 0 0 0 0 0 0 0 
830 830 1025 346 0 0 0 1022 1010 1010 1010 1010 1010 1010 1031 0 0 0 0 0 346 0 0 0 0 0 0 0 
986 947 1025 0 0 0 0 1025 989 989 989 989 989 989 1025 0 0 0 0 0 0 0 0 0 0 0 0 0 
1010 1010 1013 0 0 346 0 1025 989 1 989 989 686 989 1025 0 0 0 346 0 0 0 0 0 0 0 0 0 
0 0 0 0 0 0 971 1025 989 989 989 989 989 989 1025 0 0 0 346 346 0 0 0 0 0 0 0 0 
0 0 346 346 0 0 830 1025 989 989 989 989 686 989 1025 0 0 0 0 0 0 0 0 0 346 0 0 0 
0 0 346 0 0 0 929 1025 989 989 989 989 989 989 1025 0 0 0 0 0 346 0 0 0 0 0 0 0 
0 0 0 0 1022 1010 1010 1013 1043 1043 1043 1022 1010 1010 1016 1010 1010 1031 0 0 0 0 0 0 0 0 0 0 
0 0 0 0 1025 0 0 0 0 0 0 1025 0 0 0 0 0 1025 0 0 0 0 0 346 0 0 0 0 
346 0 0 0 1025 0 0 0 0 0 0 1025 0 911 830 902 0 1025 0 0 0 0 0 0 0 0 0 0 
0 346 0 0 1025 0 0 0 0 0 0 1001 0 0 0 0 0 1025 0 0 0 0 346 0 0 0 0 0 
0 0 0 0 1025 1043 1043 1043 0 995 0 0 0 0 0 0 0 1025 0 0 0 0 0 0 0 346 0 0 
0 346 346 0 1025 1043 1043 1043 0 0 0 1019 0 785 830 977 0 1025 0 0 0 0 0 0 346 346 0 0 
0 346 346 0 1025 0 1043 1043 0 0 0 1025 0 0 0 0 0 1025 0 0 0 346 0 0 0 0 0 0 
0 0 0 0 1004 1010 1010 1010 1010 1010 1010 1016 1010 1010 1010 1010 1010 1013 0 0 0 0 0 0 0 0 0 0 
0 0 0 0 0 0 0 0 0 0 0 0 0 0 0 0 0 0 0 0 0 0 0 0 0 0 0 0