785 830 977 0 0 0 0 0 0 0 0 0 0 0 0 0 0 0 0 0 0 0 0 0 0 0 0 0 
725 830 986 0 0 0 0 0 0 0 0 0 0 0 0 0 0 0 0 0 0 0 0 0 0 0 0 0 
0 0 0 0 0 0 0 0 0 0 0 0 0 0 0 0 0 0 0 0 0 0 0 0 0 0 0 0 
0 0 0 0 0 0 0 0 0 0 0 0 0 0 701 701 701 701 701 701 701 701 701 701 701 0 0 0 
0 0 0 0 0 0 0 0 0 0 0 0 0 0 701 0 0 0 0 0 0 0 0 0 701 0 0 0 
0 0 0 0 0 0 0 0 0 0 0 0 0 0 701 0 932 0 0 0 0 0 0 0 701 0 0 0 
0 0 911 830 902 0 0 0 0 0 0 0 0 0 701 0 830 0 0 0 0 0 0 0 701 0 0 0 
0 0 0 0 0 0 0 0 0 0 0 0 0 0 701 0 755 0 0 0 0 0 0 0 701 0 0 0 
0 0 0 0 0 0 0 0 0 0 0 0 0 0 701 0 0 0 0 0 0 0 0 0 701 0 0 0 
0 0 0 0 0 701 0 701 0 0 0 0 0 0 701 0 0 0 0 0 0 0 0 0 701 0 0 0 
0 0 0 0 0 701 686 701 0 0 0 0 0 0 701 0 0 0 0 0 322 0 0 0 701 0 0 0 
0 0 0 701 701 701 686 701 701 701 0 0 0 0 701 0 0 0 0 0 0 0 0 0 701 0 0 0 
0 0 0 701 0 0 686 0 0 701 0 0 0 0 701 701 701 701 701 701 701 701 701 701 701 0 0 0 
0 0 0 701 0 0 0 0 0 701 0 0 0 0 0 0 0 0 0 0 0 0 0 0 0 0 0 0 
0 0 0 701 0 0 1 0 0 701 0 0 0 0 0 0 0 0 0 0 0 0 0 0 0 0 0 0 
0 0 0 701 0 0 0 0 0 701 0 0 0 0 0 0 0 0 0 0 0 0 0 0 0 0 0 0

1107 1108 1107 0 0 0 0 0 0 0 0 0 0 0 0 0 0 0 0 0 0 0 0 0 0 0 0 0 
1098 1108 1098 0 0 0 0 0 0 0 0 0 0 0 0 0 0 0 0 0 0 0 0 0 0 0 0 0 
0 0 0 0 0 0 0 0 0 0 0 0 0 0 0 0 0 0 0 0 0 0 0 0 0 0 0 0 
0 0 0 0 0 0 0 0 0 0 0 0 0 0 1103 1103 1103 1103 1103 1103 1103 1103 1103 1103 1103 0 0 0 
0 0 0 0 0 0 0 0 0 0 0 0 0 0 1103 0 0 0 0 0 0 0 0 0 1103 0 0 0 
0 0 0 0 0 0 0 0 0 0 0 0 0 0 1103 0 1096 0 0 0 0 0 0 0 1103 0 0 0 
0 0 1100 1108 1100 0 0 0 0 0 0 0 0 0 1103 0 1108 0 0 0 0 0 0 0 1103 0 0 0 
0 0 0 0 0 0 0 0 0 0 0 0 0 0 1103 0 1096 0 0 0 0 0 0 0 1103 0 0 0 
0 0 0 0 0 0 0 0 0 0 0 0 0 0 1103 0 0 0 0 0 0 0 0 0 1103 0 0 0 
0 0 0 0 0 1103 0 1103 0 0 0 0 0 0 1103 0 0 0 0 0 0 0 0 0 1103 0 0 0 
0 0 0 0 0 1103 1114 1103 0 0 0 0 0 0 1103 0 0 0 0 0 1124 0 0 1103 1103 0 0 0 
0 0 0 1103 1103 1103 1114 1103 1103 1103 0 0 0 0 1103 0 0 0 0 0 0 0 0 0 1103 0 0 0 
0 0 0 1103 0 0 1114 0 0 1103 0 0 0 0 1103 1103 1103 1103 1103 1103 1103 1103 1103 1103 1103 0 0 0 
0 0 0 1103 0 0 0 0 0 1103 0 0 0 0 0 0 0 0 0 0 0 0 0 0 0 0 0 0 
0 0 0 1103 0 0 0 0 0 1103 0 0 0 0 0 0 0 0 0 0 0 0 0 0 0 0 0 0 
0 0 0 1103 0 0 0 0 0 1103 0 0 0 0 0 0 0 0 0 0 0 0 0 0 0 0 0 0