968 830 947 1043 1043 0 995 0 0 0 0 0 995 0 0 0 995 0 0 0 0 1043 1043 1043 1043 1043 1043 0 
1043 1043 1043 1043 0 0 995 0 0 0 0 0 0 0 31 0 995 0 0 0 0 1043 1043 1043 1043 1043 0 0 
1043 1043 0 0 0 0 995 0 0 0 0 0 995 0 0 0 995 0 0 0 1043 1043 1043 1043 1043 1043 0 0 
1043 0 0 0 0 0 995 0 725 830 986 0 995 995 995 995 995 0 0 0 1043 1043 1043 1043 1043 0 0 0 
0 0 0 0 0 0 995 995 0 0 0 995 995 0 0 0 0 0 0 1043 1043 1043 1043 1043 1043 0 0 0 
0 0 0 0 0 0 995 0 0 0 0 0 686 0 0 0 0 0 0 1043 1043 1043 1043 1043 0 0 0 0 
0 0 0 0 0 0 995 995 995 995 995 995 995 0 0 0 0 0 1043 1043 1043 1043 1043 0 0 0 0 0 
0 0 0 0 0 0 995 911 995 0 0 0 0 0 0 0 0 0 1043 1043 1043 1043 0 0 0 0 0 0 
0 0 0 0 0 0 0 830 0 0 0 0 0 0 0 0 0 1043 1043 1043 1043 1043 0 0 0 0 0 0 
0 0 0 0 0 0 0 902 0 0 0 0 0 0 0 0 0 1043 1043 1043 1043 0 0 0 0 0 0 0 
0 0 0 0 0 0 0 0 0 0 0 0 839 0 0 0 1043 1043 1043 1043 1043 0 0 0 0 0 0 0 
0 0 0 0 0 0 0 0 0 0 0 0 0 0 0 1043 1043 1043 1043 1043 0 0 0 0 322 0 0 0 
1043 0 0 0 0 0 0 995 725 830 863 995 0 0 0 1043 1043 1043 1043 1043 0 0 0 0 0 0 0 0 
1043 1043 0 0 0 0 0 995 995 995 995 995 0 0 1043 1043 1043 1043 1043 0 0 0 0 785 830 977 0 0 
1043 1043 1043 0 0 0 0 995 839 830 824 995 0 0 1043 1043 1043 1043 1043 0 0 0 0 0 0 0 0 1043 
1043 1043 1043 1043 1043 0 0 995 995 995 995 995 0 1043 1043 1043 1043 1043 0 0 0 0 0 0 0 1043 1043 1043

1094 1108 1099 1117 1117 0 1102 0 0 0 0 0 1102 0 0 0 1102 0 0 0 0 1117 1117 1117 1117 1117 1117 0 
1117 1117 1117 1117 0 0 1102 0 0 0 0 0 0 0 1115 0 1102 0 0 0 0 1117 1117 1117 1117 1117 0 0 
1117 1117 0 0 0 0 1102 0 0 0 0 0 1102 0 0 0 1102 0 0 0 1117 1117 1117 1117 1117 1117 0 0 
1117 0 0 0 0 0 1102 0 1098 1108 1098 0 1102 1102 1102 1102 1102 0 0 0 1117 1117 1117 1117 1117 0 0 0 
0 0 0 0 0 0 1102 1102 0 0 0 1102 1102 0 0 0 0 0 0 1117 1117 1117 1117 1117 1117 0 0 0 
0 0 0 0 0 0 1102 0 0 0 0 0 1114 0 0 0 0 0 0 1117 1117 1117 1117 1117 0 0 0 0 
0 0 0 0 0 0 1102 1102 1102 1102 1102 1102 1102 0 0 0 0 0 1117 1117 1117 1117 1117 0 0 0 0 0 
0 0 0 0 0 0 1102 1100 1102 0 0 0 0 0 0 0 0 0 1117 1117 1117 1117 0 0 0 0 0 0 
0 0 0 0 0 0 0 1108 0 0 0 0 0 0 0 0 0 1117 1117 1117 1117 1117 0 0 0 0 0 0 
0 0 0 0 0 0 0 1100 0 0 0 0 0 0 0 0 0 1117 1117 1117 1117 0 0 0 0 0 0 0 
0 0 0 0 0 0 0 0 0 0 0 0 1110 0 0 0 1117 1117 1117 1117 1117 0 0 0 0 0 0 0 
0 0 0 0 0 0 0 0 0 0 0 0 0 0 0 1117 1117 1117 1117 1117 0 0 0 0 1124 0 0 0 
1117 0 0 0 0 0 0 1102 1098 1108 1116 1102 0 0 0 1117 1117 1117 1117 1117 0 0 0 0 0 0 0 0 
1117 1117 0 0 0 0 0 1102 1102 1102 1102 1102 0 0 1117 1117 1117 1117 1117 0 0 0 0 1117 1108 1117 0 0 
1117 1117 1117 0 0 0 0 1102 1110 1108 1110 1102 0 0 1117 1117 1117 1117 1117 0 0 0 0 0 0 0 0 1117 
1117 1117 1117 1117 1117 0 0 1102 1102 1102 1102 1102 0 1117 1117 1117 1117 1117 0 0 0 0 0 0 0 1117 1117 1117
