911 830 947 0 686 346 346 346 346 346 0 0 0 0 0 701 0 0 0 0 0 0 0 0 0 346 346 346 
0 0 0 0 686 0 346 346 0 0 0 0 0 0 0 701 0 0 0 0 0 0 0 0 0 0 346 346 
932 830 755 0 686 0 0 0 0 0 995 995 995 995 995 701 995 995 995 995 995 995 995 995 0 0 0 346 
0 0 0 0 686 0 325 0 0 112 995 0 0 0 0 701 0 0 0 995 989 989 989 995 0 0 0 0 
785 830 977 0 686 0 0 0 112 112 995 0 0 0 0 701 0 0 0 0 989 322 989 995 0 0 0 0 
0 0 0 0 686 0 995 995 995 995 995 0 0 0 0 701 0 0 0 995 989 989 989 995 0 0 325 0 
686 686 686 686 686 0 995 989 989 989 995 0 0 0 0 701 0 0 0 995 995 995 995 995 0 0 0 0 
0 0 0 0 0 0 995 989 1 989 0 0 0 0 0 701 995 995 995 995 112 112 0 0 0 0 0 0 
0 0 0 325 0 0 995 989 989 989 995 0 0 0 0 701 701 701 701 701 701 701 701 701 701 701 701 701 
0 0 0 0 0 0 995 995 995 995 995 0 0 0 0 0 0 0 995 112 112 0 0 0 0 0 0 0 
0 0 346 0 0 0 0 0 0 0 995 0 0 0 968 830 947 0 995 112 0 0 0 0 325 0 0 0 
0 346 346 346 0 0 725 0 0 0 995 0 0 0 0 0 0 0 995 0 0 0 0 0 0 0 0 0 
0 0 346 346 0 0 830 0 0 0 995 995 995 995 995 995 995 995 995 0 0 325 0 0 0 0 0 0 
0 0 0 0 0 0 986 0 0 0 0 0 0 0 0 0 0 0 325 0 0 0 0 0 0 0 0 0 
0 0 0 0 0 0 0 0 0 0 0 0 0 0 0 0 0 0 0 0 0 0 346 346 346 346 0 0 
0 0 0 0 0 0 0 0 0 0 0 0 0 0 0 0 0 0 0 0 346 346 346 346 346 346 346 346

1100 1108 1099 0 1114 1099 1099 1099 1099 1099 0 0 0 0 0 1103 0 0 0 0 0 0 0 0 0 1099 1099 1099 
0 0 0 0 1114 0 1099 1099 0 0 0 0 0 0 0 1103 0 0 0 0 0 0 0 0 0 0 1099 1099 
1096 1108 1096 0 1114 0 0 0 0 0 1102 1102 1102 1102 1102 1103 1102 1102 1102 1102 1102 1102 1102 1102 0 0 0 1099 
0 0 0 0 1114 0 1116 0 0 1100 1102 0 0 0 0 1103 0 0 0 1102 1095 1095 1095 1102 0 0 0 0 
1117 1108 1117 0 1114 0 0 0 1100 1100 1102 0 0 0 0 1103 0 0 0 0 1095 1124 1095 1102 0 0 0 0 
0 0 0 0 1114 0 1102 1102 1102 1102 1102 0 0 0 0 1103 0 0 0 1102 1095 1095 1095 1102 0 0 1116 0 
1114 1114 1114 1114 1114 0 1102 1095 1095 1095 1102 0 0 0 0 1103 0 0 0 1102 1102 1102 1102 1102 0 0 0 0 
0 0 0 0 0 0 1102 1095 0 1095 0 0 0 0 0 1103 1102 1102 1102 1102 1100 1100 0 0 0 0 0 0 
0 0 0 1116 0 0 1102 1095 1095 1095 1102 0 0 0 0 1103 1103 1103 1103 1103 1103 1103 1103 1103 1103 1103 1103 1103 
0 0 0 0 0 0 1102 1102 1102 1102 1102 0 0 0 0 0 0 0 1102 1100 1100 0 0 0 0 0 0 0 
0 0 1099 0 0 0 0 0 0 0 1102 0 0 0 1094 1108 1099 0 1102 1100 0 0 0 0 1116 0 0 0 
0 1099 1099 1099 0 0 1098 0 0 0 1102 0 0 0 0 0 0 0 1102 0 0 0 0 0 0 0 0 0 
0 0 1099 1099 0 0 1108 0 0 0 1102 1102 1102 1102 1102 1102 1102 1102 1102 0 0 1116 0 0 0 0 0 0 
0 0 0 0 0 0 1098 0 0 0 0 0 0 0 0 0 0 0 1116 0 0 0 0 0 0 0 0 0 
0 0 0 0 0 0 0 0 0 0 0 0 0 0 0 0 0 0 0 0 0 0 1099 1099 1099 1099 0 0 
0 0 0 0 0 0 0 0 0 0 0 0 0 0 0 0 0 0 0 0 1099 1099 1099 1099 1099 1099 1099 1099
