0 0 0 0 0 0 0 0 0 0 0 0 0 0 0 0 0 0 0 0 0 0 0 0 0 0 0 0 
0 0 0 0 0 0 0 0 0 0 0 0 0 0 0 0 0 0 0 0 0 0 0 0 0 0 0 0 
0 0 0 0 0 0 0 0 0 0 0 0 0 0 0 0 0 0 0 0 0 0 0 0 0 0 0 0 
0 0 0 0 0 0 0 995 995 995 995 995 995 995 995 995 995 995 995 995 995 995 0 0 0 0 0 0 
0 0 0 0 0 0 0 995 0 0 0 0 346 0 0 0 0 0 0 0 0 995 0 0 0 0 0 0 
0 0 0 0 0 0 0 995 0 725 830 986 0 0 0 0 0 0 0 322 0 995 0 0 0 0 0 0 
0 0 0 0 0 0 0 995 346 0 0 0 0 0 0 0 346 0 0 0 0 995 0 0 0 0 0 0 
0 0 0 0 0 0 0 995 0 0 0 0 0 0 0 0 0 346 0 346 0 995 0 0 0 0 0 806 
0 0 0 0 0 0 0 995 0 0 0 46 0 0 0 346 0 0 346 0 346 995 0 0 0 0 0 830 
0 0 0 0 0 0 0 995 346 0 0 0 0 0 0 346 0 785 0 977 0 995 0 0 0 0 0 947 
0 0 0 0 0 0 0 995 0 346 0 0 0 0 0 346 0 0 346 0 0 995 0 0 0 0 0 0 
0 0 0 0 0 0 0 995 0 0 0 0 346 0 0 0 346 0 0 0 0 995 0 0 0 0 0 0 
0 0 0 0 0 0 0 995 995 995 995 995 995 995 995 995 995 995 995 995 995 995 0 0 0 0 0 0 
0 0 0 0 0 0 0 0 0 0 0 0 0 0 0 0 0 0 0 0 0 0 0 0 0 0 0 0 
0 0 0 0 0 0 0 0 0 0 0 0 0 0 0 0 0 0 0 0 0 0 0 0 0 0 0 0 
0 0 0 0 0 0 0 0 0 0 0 0 0 0 0 0 0 0 0 0 0 0 0 0 0 0 0 0

0 0 0 0 0 0 0 0 0 0 0 0 0 0 0 0 0 0 0 0 0 0 0 0 0 0 0 0 
0 0 0 0 0 0 0 0 0 0 0 0 0 0 0 0 0 0 0 0 0 0 0 0 0 0 0 0 
0 0 0 0 0 0 0 0 0 0 0 0 0 0 0 0 0 0 0 0 0 0 0 0 0 0 0 0 
0 0 0 0 0 0 0 1102 1102 1102 1102 1102 1102 1102 1102 1102 1102 1102 1102 1102 1102 1102 0 0 0 0 0 0 
0 0 0 0 0 0 0 1102 0 0 0 0 1099 0 0 0 0 0 0 0 0 1102 0 0 0 0 0 0 
0 0 0 0 0 0 0 1102 0 1098 1108 1098 0 0 0 0 0 0 0 1124 0 1102 0 0 0 0 0 0 
0 0 0 0 0 0 0 1102 1099 0 0 0 0 0 0 0 1099 0 0 0 0 1102 0 0 0 0 0 0 
0 0 0 0 0 0 0 1102 0 0 0 0 0 0 0 0 0 1099 0 1099 0 1102 0 0 0 0 0 1113 
0 0 0 0 0 0 0 1102 0 0 0 1115 0 0 0 1099 0 0 1099 0 1099 1102 0 0 0 0 0 1108 
0 0 0 0 0 0 0 1102 1099 0 0 0 0 0 0 1099 0 1117 0 1117 0 1102 0 0 0 0 0 1099 
0 0 0 0 0 0 0 1102 0 1099 0 0 0 0 0 1099 0 0 1099 0 0 1102 0 0 0 0 0 0 
0 0 0 0 0 0 0 1102 0 0 0 0 1099 0 0 0 1099 0 0 0 0 1102 0 0 0 0 0 0 
0 0 0 0 0 0 0 1102 1102 1102 1102 1102 1102 1102 1102 1102 1102 1102 1102 1102 1102 1102 0 0 0 0 0 0 
0 0 0 0 0 0 0 0 0 0 0 0 0 0 0 0 0 0 0 0 0 0 0 0 0 0 0 0 
0 0 0 0 0 0 0 0 0 0 0 0 0 0 0 0 0 0 0 0 0 0 0 0 0 0 0 0 
0 0 0 0 0 0 0 0 0 0 0 0 0 0 0 0 0 0 0 0 0 0 0 0 0 0 0 0
