785 830 977 0 0 0 0 0 0 0 0 0 0 0 0 0 0 0 0 0 0 0 0 0 0 0 0 0 
0 992 0 0 0 0 0 0 0 0 0 0 0 0 0 0 0 992 0 0 0 0 0 0 0 0 0 0 
0 0 0 0 0 896 830 902 0 0 0 0 0 683 0 0 0 0 0 683 0 992 0 0 0 0 0 0 
0 0 0 0 0 0 0 0 0 0 0 0 0 0 0 683 0 0 0 0 0 0 0 0 0 0 0 0 
0 0 0 112 112 112 0 112 0 112 0 0 0 0 0 0 0 0 0 0 0 0 0 0 992 0 0 0 
0 0 0 112 995 995 995 995 995 112 0 0 0 0 0 0 0 704 704 704 704 704 0 0 0 0 0 0 
968 0 0 112 995 989 989 989 995 112 0 0 0 0 0 0 112 704 112 112 112 704 0 0 0 0 0 0 
830 0 0 112 995 989 1 989 683 112 112 112 112 112 112 112 112 704 112 322 112 704 0 992 0 0 0 0 
947 0 0 112 995 989 989 989 995 112 992 0 0 0 0 0 0 704 112 112 112 704 0 0 0 0 0 0 
0 0 0 112 995 995 995 995 995 112 0 0 0 0 0 0 0 704 704 704 704 704 0 0 0 0 0 0 
0 0 0 112 112 0 0 112 112 112 0 0 0 0 0 0 0 0 0 0 0 0 0 0 0 0 0 0 
0 0 0 0 0 0 0 0 0 0 0 0 0 683 0 0 0 0 0 0 0 0 0 0 992 0 0 0 
0 0 992 0 0 0 0 0 0 0 0 0 0 0 0 992 0 0 0 0 0 0 0 0 0 0 0 0 
0 0 0 0 0 725 830 986 0 0 0 0 0 0 992 0 0 0 992 0 0 683 0 0 0 0 0 0 
0 0 0 0 0 0 0 0 0 0 0 0 0 0 0 0 0 0 0 0 0 0 0 0 0 0 0 0 
0 0 0 0 0 0 0 0 0 0 0 0 0 0 0 0 0 0 0 0 0 0 0 0 0 938 830 755

1117 1108 1117 0 0 0 0 0 0 0 0 0 0 0 0 0 0 0 0 0 0 0 0 0 0 0 0 0 
0 1113 0 0 0 0 0 0 0 0 0 0 0 0 0 0 0 1113 0 0 0 0 0 0 0 0 0 0 
0 0 0 0 0 1102 1108 1100 0 0 0 0 0 1109 0 0 0 0 0 1109 0 1113 0 0 0 0 0 0 
0 0 0 0 0 0 0 0 0 0 0 0 0 0 0 1109 0 0 0 0 0 0 0 0 0 0 0 0 
0 0 0 1121 1121 1121 0 1121 0 1121 0 0 0 0 0 0 0 0 0 0 0 0 0 0 1113 0 0 0 
0 0 0 1121 1102 1102 1102 1102 1102 1121 0 0 0 0 0 0 0 1117 1117 1117 1117 1117 0 0 0 0 0 0 
1102 0 0 1121 1102 1095 1095 1095 1102 1121 0 0 0 0 0 0 1121 1117 1121 1121 1121 1117 0 0 0 0 0 0 
1108 0 0 1121 1102 1095 0 1095 1109 1121 1121 1121 1121 1121 1121 1121 1121 1117 1121 1124 1121 1117 0 1113 0 0 0 0 
1099 0 0 1121 1102 1095 1095 1095 1102 1121 1113 0 0 0 0 0 0 1117 1121 1121 1121 1117 0 0 0 0 0 0 
0 0 0 1121 1102 1102 1102 1102 1102 1121 0 0 0 0 0 0 0 1117 1117 1117 1117 1117 0 0 0 0 0 0 
0 0 0 1121 1121 0 0 1121 1121 1121 0 0 0 0 0 0 0 0 0 0 0 0 0 0 0 0 0 0 
0 0 0 0 0 0 0 0 0 0 0 0 0 1109 0 0 0 0 0 0 0 0 0 0 1113 0 0 0 
0 0 1113 0 0 0 0 0 0 0 0 0 0 0 0 1113 0 0 0 0 0 0 0 0 0 0 0 0 
0 0 0 0 0 1097 1108 1097 0 0 0 0 0 0 1113 0 0 0 1113 0 0 1109 0 0 0 0 0 0 
0 0 0 0 0 0 0 0 0 0 0 0 0 0 0 0 0 0 0 0 0 0 0 0 0 0 0 0 
0 0 0 0 0 0 0 0 0 0 0 0 0 0 0 0 0 0 0 0 0 0 0 0 0 1110 1108 1096